. . . . . . o o o O o o o . . . . . .
. . . . x x o o o o o o o x x . . . .
. . r r x x x o o o o o x x x y y . .
. . r r r x x x o o o x x x y y y . .
. R r r r x x x x x x x x x y y y Y .
. r r r r x x x x x x x x x y y y y .
r r r r x x x x w w w x x x x y y y y
r r r x x x x w w w w w x x x x y y y
x x x x x x w w w w w w w x x x x x x
x x x x x x w w w W w w w x x x x x x
x x x x x x w w w w w w w x x x x x x
m m m x x x x w w w w w x x x x g g g
m m m m x x x x w w w x x x x g g g g
. m m m m x x x x x x x x x g g g g .
. M m m m x x x x x x x x x g g g G .
. . m m m x x x b b b x x x g g g . .
. . m m x x x b b b b b x x x g g . .
. . . . x x b b b b b b b x x . . . .
. . . . . . b b b B b b b . . . . . .