. . . R r r r m m M . . .
. . . r r r m m m m . . .
. . r r r x x x m m m . .
. . o r x x x x x m c . .
. o o o x w w w x c c c .
O o o x x w w w x x c c C
. o o o x w w w x c c c .
. . o y x x x x x g c . .
. . y y y x x x g g g . .
. . . y y y y g g g . . .
. . . Y y y g g g G . . .